╝│ │ │╚╗XXXX
─┘ │ │ ║XXXX
╗┌─┘ │ ╚═══╗
╝└┐  └────┐║
──┘┌───┐  │║
╗  │   │┌─┘║
╚═╗│╔═╗││╔═╝